20,20
1
00000000000000000000
00033000000000000000
00300100000000000000
00100010000000000000
00300002111113000000
00020000000000100000
00020000000000010000
00100000000000003000
03000000000000001000
01000000000000001000
03000000000000001000
00311200000000003000
00000020000000010000
00000020000000100000
00000100000213000000
00003000002000000400
00001000001000001000
00001000002000010000
0000X000000211200000
00000000000000000000

# start at X, end at 4
# 1 = forward, 3 = right, 2 =left
