20,20
1
00021200000000000400
00200010000000000100
00100003111200000300
00200000000010001000
00010000000003130000
00002111300000000000
00000000010000000000
00000000001000000000
00003130000100000000
00010001000031120000
00300000300000001000
00100000100000000200
00300000100000000100
00010000100000000100
00001000200000000200
00000200010000001000
00000100001000010000
00000100000211200000
00000X00000000000000
00000000000000000000

# start at X, end at 4
# 1 = forward, 3 = right, 2 =left
